1 . . . . . . 4
. . . . . . . .
X X . . . . X X
. . . . . . . .
3 . . . . . . 2