1 . . . .
. . . . .
. . . . .
. . . . .
. . . . 2
