1 . . . 2
. . . . .
. . X . .
. . . . .
3 . . 4 4
