1 . . . . .
. . . . . .
. . . . . .
. . . . . .
. . . . . .
. . . . . 2